**********
**********
***D******
*>.......*
**********
