**********
*...*....*
*.******.*
*.......D*
*^******.*
*......*.*
*.*.**.*.*
*.*.*..*.*
**********
