***************
*>............*
**.*.*.*.*.*.**
**......D....**
***************
