**********
*^.......*
********.*
********.*
********D*
**********
