********************
*.>................*
******************.*
*................*.*
*..............*...*
*..............***.*
*..............*D*.*
*................*.*
*................*.*
*................*.*
*................*.*
*................*.*
********************
