**********
*>.......*
**.......*
**.......*
**......D*
**********
