**********
*>.......*
**.......*
**.D.....*
**.......*
**********
