********************
*..........**......*
****.*****.***.***.*
****.***.......***.*
*....***^*****...*.*
*.**..********.***.*
*.***.************.*
*..................*
***.****.***.****.**
***.*....***.****.**
***.********......**
***..........***.***
***.*****.******.***
*...*****.**D***.***
*.*.*****....***...*
*.*.*****.******.*.*
*.*..............*.*
*.*.********.*****.*
*........***.......*
********************
