***********
*>........*
**.*D*.**.*
******.**.*
***********
