**********
**********
**********
*....D****
*.********
*.********
*^********
**********
