***************
*>............*
*****.**.***.**
*****.**...*.**
*****....*..D**
***************

