**********
****.*****
****.*****
*...^D****
*.**.*****
*....*****
**********
