**********
*........*
*.**.***.*
*.*D^....*
*.**.***.*
*........*
**********
