**********
******...*
****D*.*.*
*...^....*
*.**.**.**
*....**.**
**********
