**********
*........*
*.******.*
*.*....*.*
*.*.**.*.*
*.*.**.*.*
*.*.*D.*.*
*.*.****.*
*^*......*
**********
