***************
*>............*
***.*.*.*.*.*.*
***.*.*.*D*.*.*
***************
