**********
*>....D..*
**.......*
**.......*
**.......*
**********
