********************
*..................*
*.****************.*
*.*..............*.*
*.*.************.*.*
*.*.*..........*.*.*
*.*.*.********.*.*.*
*.*.*.*......*.*.*.*
*.*.*.*.****.*.*.*.*
*.*.*.*.*.D*.*.*.*.*
*.*.*.*.*.**.*.*.*.*
*.*.*.*.*.**.*.*.*.*
*.*.*.*.*....*.*.*.*
*.*.*.*.******.*.*.*
*.*.*.*........*.*.*
*.*.*.**********.*.*
*.*.*............*.*
*.*.**************.*
*^*................*
********************
