*******
*....D*
*.*****
*.*****
*.*****
*.*****
*^*****
*******
