***************
*............<*
**.*.**.*.**.**
**.******.**.**
**D....*.....**
***************
