***************
*............<*
*.**.*.**.*.***
*.**.****.***.*
*D.....**.....*
***************
