**********
****D*****
****.*****
*>.......*
**********
