**********
*>......**
*******.**
*******.**
*******D**
**********
