**********
*>......**
*****D*.**
*******.**
**********
**********
