**********
*....*****
*.**.*****
*.**.*****
*.**...***
*.****.***
*.****...*
*.******.*
*....D**^*
**********
