**********
*>.......*
********.*
****...*.*
****.*.*.*
*....*...*
*.********
*.*...**D*
*...*....*
**********
