**********
****^*****
****.*****
****.*****
****D*****
**********
