********************
**....**.*..***D**.*
**.**.**.*.**.*.**.*
*..................*
**.*****.***********
**.....*.*......****
********.*.*.**.*.**
*.................**
*************.*.*.**
*>..........*****.**
***.****.****.*...**
***.*..*.****.***.**
*...**.*...........*
***....*.***********
********************
