********************
****.*****.........*
**.........*.****.**
**.***.***.*.*.....*
**.***.***.*.*.*.*.*
*..........*.*D*...*
*.**********.***.***
*..................*
*.***.**.*****.***.*
*..**...^*****...*.*
**..****......**...*
***..****.***.******
*.**..*............*
*.***.*.*.********.*
*.....*.*........*.*
**.****.********.*.*
**...............*.*
**.***************.*
**.................*
********************
