**********
*......D**
*.********
*...******
***.******
**..******
**.*******
**...*****
****^*****
**********
