**********
*.D*******
*.********
*.********
*.********
*.********
*^********
**********
