***************
*>............*
****.***.**.***
*....***.**.***
****.....**D***
***************
