*************
*...........*
*.*********.*
*.*********D*
*^***********
*************
