**********
*******.**
****D...**
*******.**
****.**.**
*.**.**.**
*.......**
*.****.***
*^*....***
**********
