**********
****.....*
***D.*****
****.*****
*.**.**.**
*....**.**
*.*.***.**
*.*......*
*^********
**********
