************
*..........*
*.********.*
*.********.*
*.********D*
*.**********
*.**********
*.**********
*^**********
************
