**********
*........*
*.**.*****
*...^...**
*.**D*****
**********
**********
