**********
*>......**
*.**.**.**
*D**.**.**
*******.**
**********
