**********
******D***
******.***
*>.......*
**********
