**********
*>.......*
***.*.**.*
***D*.****
*****....*
**********
