**********
*D**.....*
*.**.***.*
*.**...*.*
*.****.*.*
*.****.*.*
*......*.*
********.*
*>.......*
**********
