**********
*.......D*
*.********
*.********
*^********
**********
