**********
***......*
***.****.*
***.****.*
***^****D*
**********
