********************
*.>................*
***.*.************.*
*...*.*.*...*....*.*
*.*.*.*...*...*.**.*
*.*.*.***.*****.**.*
*.*.*...*.....*.**.*
*.*****.*****.*.**.*
*.....*.....*.*.D*.*
*****.*****.*.****.*
*...*.....*.*....*.*
*.*.*****.*.****.*.*
*.*.......*.*....*.*
*.*********.*.****.*
*.........*.*......*
*.*.*****.*.********
*.*.....*..........*
*.*****.*.*.******.*
*.......*..........*
********************
