********************
*.>................*
******************.*
*D.................*
********************
