***********
*>........*
****.**.*.*
****.**D*.*
***********
