**********
*****..D**
*****.****
*****....*
********.*
*........*
*.********
*....*****
****^*****
**********
